**********************************************************************************************************************************************
**********************                  ******************************************************************************************************
*************************************** ************************    **************************************************************************
*************************************** ******************       *****************************************************************************
*************************************** ************       ***********************************************************************************
*                      **************** ******        ****************************************************************************************
*********************  **************** **      ************************                                                **********************
*********************  ****************    ***************************** ********************************** *********** **********************
**********             **************** ******************************** ********************************** *********** **********************
********************** **************** ******************************** ********************************** *********** **********************
********************** ****************  ******************************* ********************************** *********** **********************
********************** *****************                                 ********************************** *********** **********************
********************** ************************************************* ********************************** *********** **********************
********************** ************************************************* ********************************** *********** **********************
********************** ************************************************* ********************************** *********** **********************
********************** ************************************************* ********************************** *********** **********************
********************** ************************************************* *********                          *********** **********************
**********************                                                   ********* ************************ ***********                       
*********************** ********** *********************************************** ************************ **********************************
*********************** ********** *********************************************** ************************ **********************************
*********************** ********** *********************************************** ************************ **********************************
************            ********** ********************                                                     **********************************
************ ********************* ******************** **************************************************************************************
************ *********************  ******************* **************************************************************************************
************ *********************                      **************************************************************************************
************ ****************************************** **************************************************************************************
************ ****************************************** **************************************************************************************
************ ****************************************** **************************************************************************************
************ ***************************   ***          **************************************************************************************
************ *************************** *      ******* **************************************************************************************
************ *************************** **************                                                      *********************************
************ *************************** ******************************************************************* *********************************
************ *************************** ******************************************************************* *********************************
************ *************************** ******************************************************************* *********************************
************ *************************** ******************************************************************* *********************************
************                             ******************************************************************* *********************************
************************************************************************************************************ *********************************
************************************************************************************************************ *********************************
************************************************************************************************************ *********************************
************************************************************************************************************ *********************************
************************************************************************************************************ *********************************
************************************************************************************************************ *********************************
************************************************************************************************************ *********************************
************************************************************************************************************ *********************************
************************************************************************************************************ *********************************
