*********************************************************************
*                                                                   *
*                                                                   *
*********  *******    ***      *******  *****                ********
*                *      *      *            ************            *
*                *      *      *            *          *     *      *
*                                                                   *
*                              *            *          * *****      *
************************       *            *          *     *      *
*  *                           **************          *     *      *
*  *********************        *     *                      *      *
*  *                            *                      *     *      *
*           ****    ***         *     *                *     *      *
*  *        *         *         *     *                *     *      *
*  *        *         *         *     *                *            *
*  *        *         *         *     *                      ********
*  *        *         ***  ******     *                *            *
*  **********                         *****  ********  *            *
*                                                      *            *
*********************************************************************
