*********************************************************************
*                                                                   *
*                                   *****************               *
****************************   *    *                               *
*  *                           *    *       *****  *****    *****  **
*  *                           *    *       *                *      *
*  *******   ******      *******    *       *          *     *      *
*                              *    *       *          *     *      *
************************       *    *       *          *     *      *
*                              *       ******          *     *      *
*  * ************************  *      *                *     *      *
*  *                                  *                *     *      *
*  *        ******  ***               *************  ***     *      *
*  *        *         *               *                *     *      *
*  *        *         *               *                *     *      *
*  *        *         *               *                *     *      *
*  *        *         *               *                *     *      *
*  **********         **********  *************        *     *      *
*                                                      *            *
*********************************************************************
